1 1 1 1 1 1 1 1 1 1 1 1 1 1 1 1 1 1 1 1 1 1 1 1 1 1 1 1 1 1 1 1 1 1 1 1 1 1 1 1 1 1 1 1 1 1 1 1 1 1 1 1 1 1 1 1 1 1 1 1 1 1 1 1 1 1 1 1 1 1 1 1 1 1 1 1 1 1 1 1 1 1 1 1 1 1 1 1 1 1 1 1 1 1 1 1 1 1 1 1                                                                                
1 1 1 1 1 1 1 1 1 1 1 1 1 1 1 1 1 1 1 1 1 1 1 1 1 1 1 1 1 1 1 1 1 1 1 1 1 1 1 1 1 1 1 1 1 1 1 1 1 1 1 1 1 1 1 1 1 1 1 1 1 1 1 1 1 1 1 1 1 1 1 1 1 1 1 1 1 1 1 1 1 1 1 1 1 1 1 1 1 1 1 1 1 1 1 1 1 1 1 1                                                                               
1 1 1 1 1 1 1 1 1 1 1 1 1 1 1 1 1 1 1 1 1 1 1 1 1 1 1 1 1 1 1 1 1 1 1 1 1 1 1 1 1 1 1 1 1 1 1 1 1 1 1 1 1 1 1 1 1 1 1 1 1 1 1 1 1 1 1 1 1 1 1 1 1 1 1 1 1 1 1 1 1 1 1 1 1 1 1 1 1 1 1 1 1 1 1 1 1 1 1 1                                                                                
1 1 1 1 1 1 1 1 1 1 1 1 1 1 1 1 1 1 1 1 1 1 1 1 1 1 1 1 1 1 1 1 1 1 1 1 1 1 1 1 1 1 1 1 1 1 1 1 1 1 1 1 1 1 1 1 1 1 1 1 1 1 1 1 1 1 1 1 1 1 1 1 1 1 1 1 1 1 1 1 1 1 1 1 1 1 1 1 1 1 1 1 1 1 1 1 1 1 1 1                                                                                
1 1 1 1 6 6 6 6 6 6 6 6 6 6 6 6 6 6 6 6 6 6 6 6 6 6 6 6 6 6 6 6 6 6 6 6 6 6 6 6 6 6 6 6 6 6 6 6 6 6 6 6 6 6 6 6 6 6 6 6 6 6 6 6 6 6 6 6 6 6 6 6 6 6 6 1 1 10 10 10 10 10 10 10 10 10 10 10 10 10 10 10 10 10 10 10 1 1 1 1                                                                               
1 1 1 1 6 6 6 6 6 6 6 6 6 6 6 6 6 6 6 6 6 6 6 6 6 6 6 6 6 6 6 6 6 6 6 6 6 6 6 6 6 6 6 6 6 6 6 6 6 6 6 6 6 6 6 6 6 6 6 6 6 6 6 6 6 6 6 6 6 6 6 6 6 6 6 1 1 10 10 10 10 10 10 10 10 10 10 10 10 10 10 10 10 10 10 10 1 1 1 1                                                                               
1 1 1 1 6 6 6 6 6 6 6 6 6 6 6 6 6 6 6 6 6 6 6 6 6 6 6 6 6 6 6 6 6 6 6 6 6 6 6 6 6 6 6 6 6 6 6 6 6 6 6 6 6 6 6 6 6 6 6 6 6 6 6 6 6 6 6 6 6 6 6 6 6 6 6 6 1 1 10 10 10 10 10 10 10 10 1 1 1 1 1 10 10 10 10 10 1 1 1 1                                                                                
1 1 1 1 6 6 6 6 6 6 6 6 6 6 6 6 6 6 6 6 6 6 6 6 6 6 6 6 6 6 6 6 6 6 6 6 6 6 6 6 6 6 6 6 6 6 6 6 6 6 6 6 6 6 6 6 6 6 6 6 6 6 6 6 6 6 6 6 6 6 6 6 6 6 6 6 6 1 1 10 10 10 10 10 10 10 1 11 11 11 1 10 10 10 10 10 1 1 1 1                                                                                
1 1 1 1 6 6 6 6 6 6 6 6 6 6 6 6 6 6 6 6 6 6 6 6 6 6 6 6 6 6 6 6 6 6 6 6 6 6 6 6 6 6 6 6 6 6 6 6 6 6 6 6 6 6 6 6 6 6 6 6 6 6 6 6 6 6 6 6 6 6 6 6 6 6 6 6 6 6 1 1 10 10 10 10 10 10 1 11 11 11 1 10 10 10 10 10 1 1 1 1                                                                                
1 1 1 1 6 6 6 6 6 6 6 6 6 6 6 6 6 6 6 6 6 6 6 6 6 6 6 6 6 6 6 6 6 6 6 6 6 6 6 6 6 6 6 6 6 6 6 6 6 6 6 6 6 6 6 6 6 6 6 6 6 6 6 6 6 6 6 6 6 6 6 6 6 6 6 6 6 6 6 1 1 10 10 10 10 10 1 11 11 11 1 10 10 10 10 10 1 1 1 1                                                                                
1 1 1 1 6 6 6 6 6 5 5 6 6 6 5 5 5 6 6 6 5 5 5 6 6 6 6 6 6 6 6 6 6 6 6 6 6 6 6 6 6 6 6 6 6 6 6 6 6 6 6 6 6 6 6 6 6 6 6 6 6 6 6 6 6 6 6 6 6 6 6 6 6 6 5 6 6 6 5 1 1 10 10 10 10 10 1 11 11 11 1 10 10 10 10 10 1 1 1 1                                                                                
1 1 1 1 6 6 6 6 6 5 5 5 5 5 5 5 5 6 6 6 5 5 5 6 6 6 6 6 6 6 6 6 6 6 6 6 6 6 6 6 5 5 6 6 6 6 6 6 6 6 6 6 6 6 6 6 6 6 6 5 5 5 6 6 6 6 6 6 6 6 6 6 6 6 5 6 6 6 5 1 1 10 10 10 10 10 1 11 11 11 1 10 10 10 10 10 1 1 1 1                                                                                
1 1 1 1 6 6 6 6 6 5 5 5 5 5 5 5 5 5 5 5 5 5 5 5 5 5 6 6 6 6 6 6 5 5 6 6 6 6 6 6 5 5 6 6 6 6 6 6 6 6 6 6 6 6 6 6 6 6 6 5 5 5 6 6 6 6 6 6 6 6 6 6 6 5 5 6 6 6 5 1 1 10 10 10 10 10 1 1 11 1 1 10 10 10 10 10 1 1 1 1                                                                                
1 1 1 1 6 6 6 6 6 6 5 5 5 5 5 5 5 5 5 5 5 5 5 5 6 6 6 6 6 6 6 6 5 5 6 6 6 6 6 6 5 5 5 5 5 6 6 6 6 6 6 5 5 6 6 6 6 6 6 5 5 5 6 6 6 6 6 6 6 6 6 6 6 5 5 6 6 6 5 1 1 10 10 10 10 10 10 10 11 10 10 10 10 10 10 10 1 1 1 1                                                                                
1 1 1 1 6 6 6 6 6 6 5 5 5 5 5 5 5 1 1 1 1 1 5 5 6 6 6 6 6 6 6 6 5 5 6 6 6 6 6 6 5 5 5 5 5 6 6 6 6 6 6 5 5 6 6 6 6 6 6 5 5 5 6 6 6 6 6 6 6 6 6 6 6 5 5 5 5 5 5 1 1 10 10 10 10 10 10 10 11 10 10 10 10 10 10 10 1 1 1 1                                                                                
1 1 1 1 6 6 6 6 6 6 5 5 5 5 5 5 5 1 5 5 5 1 5 5 6 6 6 6 6 6 6 6 5 5 5 5 5 5 5 5 5 5 5 5 6 6 6 6 6 6 6 5 5 6 6 6 6 6 6 5 5 5 5 5 6 6 6 6 6 6 6 6 6 5 5 5 5 5 5 1 1 10 10 10 10 10 10 10 11 10 10 10 10 10 11 11 11 1 11 11                                                                                
1 1 1 1 6 6 6 6 6 5 5 5 5 5 5 5 5 1 5 5 5 1 5 5 6 6 6 6 6 6 6 5 5 5 5 5 5 5 5 5 5 5 5 5 6 6 6 6 6 6 5 5 5 5 6 6 6 5 5 5 5 5 5 5 6 6 6 6 6 6 6 6 6 5 5 5 5 5 5 1 1 10 10 10 10 10 10 10 11 10 10 10 10 10 11 10 1 1 1 1                                                                                
1 1 1 1 6 6 6 6 6 6 6 6 5 5 5 5 5 1 5 5 5 1 5 5 6 6 6 6 6 6 6 5 5 5 5 5 5 5 5 5 5 5 5 5 6 6 6 6 6 6 5 5 5 6 6 6 6 5 5 5 5 6 6 6 6 6 6 6 6 6 6 6 6 5 5 5 5 5 5 1 11 11 11 11 11 11 11 11 11 11 11 11 11 11 11 10 1 1 1 1                                                                                
1 1 1 1 6 6 6 6 6 6 6 6 5 5 5 5 5 1 5 5 5 1 5 5 5 6 6 6 6 6 6 6 6 6 6 5 5 5 5 5 5 6 6 6 6 6 6 6 6 6 5 5 5 6 6 6 6 5 5 5 5 6 6 6 6 6 6 6 6 6 6 6 6 5 5 5 5 5 5 1 11 11 11 11 11 11 11 11 11 11 11 11 11 11 10 10 1 1 1 1                                                                                
1 1 1 1 6 6 6 6 6 6 6 6 5 5 5 5 5 1 5 5 5 1 5 5 5 6 6 6 6 6 6 6 6 6 6 5 5 5 5 5 5 6 6 6 6 6 6 6 6 6 5 5 5 6 6 6 6 5 5 5 5 6 6 6 6 6 6 6 6 6 6 6 6 5 5 5 5 5 5 1 1 10 10 10 10 10 10 10 11 10 10 10 10 10 10 10 1 1 1 1                                                                                
1 1 1 1 6 6 6 6 6 5 5 5 5 5 5 5 5 1 1 5 1 1 5 5 5 6 6 6 6 6 6 6 6 6 6 5 5 5 5 5 5 6 6 6 5 5 5 5 5 5 5 5 5 6 6 6 5 5 5 5 5 6 6 6 6 6 6 5 5 5 5 5 5 5 5 5 5 5 5 1 1 10 10 10 10 10 10 10 11 10 10 10 10 10 10 10 1 1 1 1                                                                                
1 1 1 1 6 6 6 6 6 6 6 5 5 5 5 5 5 5 5 5 5 5 5 5 5 5 5 5 5 5 6 6 6 6 6 5 5 5 5 5 5 6 6 6 5 5 5 5 5 5 5 5 5 6 6 6 5 5 5 5 5 6 6 6 6 6 6 5 5 5 5 5 5 5 5 5 5 5 5 1 1 10 10 10 10 10 10 10 11 10 10 10 10 10 10 10 1 1 1 1                                                                                
1 1 1 1 6 6 6 6 6 6 6 5 5 5 5 5 5 5 5 5 5 5 5 5 5 5 5 5 5 5 6 6 6 6 6 5 5 5 5 5 5 6 6 6 5 5 5 5 5 5 5 5 5 5 5 5 5 5 5 5 5 5 5 5 5 5 5 5 5 5 5 5 5 5 5 5 5 5 5 1 1 10 10 10 10 10 10 10 11 10 10 10 10 10 10 10 1 1 1 1                                                                                
1 1 1 1 6 6 6 6 6 6 6 5 5 5 5 6 6 6 6 6 6 5 5 6 6 6 6 6 6 5 5 5 5 5 5 5 5 5 5 5 5 5 5 5 5 5 5 5 5 5 5 5 5 5 5 5 5 5 5 5 5 5 5 5 5 5 5 5 5 5 5 5 5 5 5 5 5 5 5 1 1 10 10 10 10 10 10 10 11 10 10 10 10 10 10 10 1 1 1 1                                                                                
1 1 1 1 6 6 6 6 6 5 5 5 5 5 5 6 6 6 6 6 6 5 5 6 6 6 6 6 6 5 5 5 5 5 5 5 5 5 5 5 5 5 5 5 5 5 5 5 5 5 5 5 5 5 5 5 6 6 6 6 6 6 6 6 6 6 5 5 5 5 5 5 5 5 5 5 5 5 5 1 1 10 10 10 10 10 10 10 11 10 10 10 10 10 10 10 1 1 1 1                                                                                
1 1 1 1 6 6 6 6 6 6 6 6 6 6 6 6 6 6 6 6 6 6 6 6 6 6 6 6 6 6 6 6 6 6 6 6 6 5 5 6 6 6 6 6 6 5 5 5 5 5 5 5 5 5 5 5 6 6 6 6 6 6 6 6 6 6 5 5 5 5 5 5 5 5 5 5 5 5 5 1 1 10 10 10 10 10 10 10 11 10 10 10 10 10 10 10 1 1 1 1                                                                                
1 1 1 1 6 6 6 6 6 6 6 6 6 6 6 6 6 6 6 6 6 6 6 6 6 6 6 6 6 6 6 6 6 6 6 6 6 6 6 6 6 6 6 6 6 6 5 5 5 5 5 6 6 6 6 6 6 6 6 6 6 6 6 6 6 6 6 6 6 6 6 6 6 6 6 6 6 6 6 1 1 10 10 10 10 10 10 10 11 10 10 10 10 10 10 10 1 1 1 1                                                                                
1 1 1 1 6 6 6 6 6 6 6 6 6 6 6 6 6 6 6 6 6 6 6 6 6 6 6 6 6 6 6 6 6 6 6 6 6 4 4 6 6 6 6 6 6 4 4 0 0 5 0 0 4 4 4 4 6 6 6 6 6 6 6 6 6 6 4 4 4 4 4 4 0 0 0 0 0 0 6 6 1 10 10 10 10 10 10 10 11 10 10 10 10 10 10 10 1 1 1 1                                                                                
1 1 1 1 6 6 6 4 4 4 6 6 6 6 6 6 6 6 6 6 6 6 6 6 6 6 6 6 6 6 6 6 6 6 6 6 6 4 4 6 6 6 6 6 6 4 4 0 0 5 0 0 4 4 4 4 6 6 6 6 6 6 6 6 6 6 4 4 4 4 4 4 0 0 0 0 0 0 6 6 1 10 10 10 10 10 10 10 11 10 10 10 10 10 10 10 1 1 1 1                                                                                
1 1 1 1 6 6 6 4 4 4 6 6 6 6 6 6 0 6 6 6 6 6 6 6 6 6 6 6 6 6 6 6 6 6 6 6 6 4 4 6 6 6 6 6 6 4 4 0 0 5 0 0 4 4 4 4 4 4 4 4 4 4 4 4 4 4 4 4 4 4 4 4 0 0 0 0 0 0 6 6 1 10 10 10 10 10 10 10 11 10 10 10 10 10 10 10 1 1 1 1                                                                                
1 1 1 1 4 4 4 4 4 4 4 4 4 4 0 0 0 0 0 0 0 4 4 4 6 6 6 4 4 4 4 4 4 4 4 4 4 4 4 4 4 4 4 4 4 4 4 0 0 5 0 0 4 4 4 4 4 4 4 4 4 4 4 4 4 4 4 4 4 4 4 4 0 0 0 0 0 0 6 6 1 10 10 10 10 10 10 10 11 10 10 10 10 10 10 10 1 1 1 1                                                                                
1 1 1 1 4 4 4 4 4 4 4 4 4 4 0 0 0 0 0 0 0 4 4 4 6 6 6 4 4 4 4 4 4 4 4 4 4 4 4 4 4 4 4 4 4 4 4 4 0 5 0 0 4 4 4 4 4 4 4 4 4 4 4 4 4 4 4 4 4 4 4 4 0 0 0 0 0 0 6 6 1 10 10 10 10 10 10 10 11 10 10 10 10 10 10 10 1 1 1 1                                                                                
1 1 1 1 4 4 4 4 4 4 4 4 4 4 0 1 1 1 1 1 0 4 4 4 4 4 4 4 4 4 0 4 4 4 4 4 0 0 0 0 4 4 4 4 4 4 4 4 0 5 0 4 4 4 4 4 4 4 4 4 4 4 4 4 4 0 0 0 0 0 0 0 0 3 0 0 0 0 0 4 1 10 10 10 10 10 10 10 11 10 10 10 10 10 10 10 1 1 1 1                                                                                
1 1 1 1 4 4 4 4 4 4 4 4 4 4 0 1 3 3 3 1 0 4 4 4 4 4 4 4 4 4 0 4 4 4 4 4 0 0 0 0 4 4 4 4 4 4 4 4 0 3 0 4 4 4 4 4 4 4 4 4 4 4 4 4 4 0 0 0 0 0 3 3 3 3 3 3 0 0 0 4 1 10 10 10 10 10 10 10 11 10 10 10 10 10 10 10 1 1 1 1                                                                                
1 1 1 1 4 4 4 4 4 4 4 4 4 4 0 1 3 3 3 1 0 4 4 4 4 4 4 4 4 4 0 4 4 4 4 4 0 0 0 0 4 4 4 4 4 4 4 4 0 3 0 4 4 4 4 4 4 4 4 4 4 4 4 4 4 0 0 0 3 3 3 3 0 0 0 3 0 0 0 4 1 10 10 10 10 10 10 10 11 10 10 10 10 10 10 10 1 1 1 1                                                                                
1 1 1 1 4 4 4 4 4 4 4 4 4 4 0 1 3 3 3 1 0 4 4 4 4 4 4 4 4 4 0 0 0 0 0 0 0 0 0 0 0 0 0 0 4 4 4 4 0 3 0 4 4 4 4 4 4 4 4 4 4 0 0 0 0 0 0 3 3 3 0 0 0 0 0 0 3 0 0 4 1 10 10 10 10 11 11 11 11 11 11 11 11 10 10 10 1 1 1 1                                                                                
1 1 1 1 4 4 4 4 4 4 4 4 4 4 0 1 3 3 3 1 0 4 4 4 4 4 4 4 4 4 0 0 0 0 0 0 0 0 0 0 0 0 0 4 4 4 4 4 0 3 0 4 4 4 4 4 4 4 4 4 4 0 0 0 0 3 3 3 0 0 0 0 0 0 0 0 3 3 0 4 1 10 10 10 10 11 11 11 11 11 11 11 11 10 10 10 1 1 1 1                                                                                
1 1 1 1 4 4 4 4 4 4 4 4 4 4 0 1 3 3 3 1 0 4 4 4 4 4 4 4 4 4 0 0 0 0 0 0 0 4 4 4 4 4 0 4 4 4 4 4 0 3 0 4 4 4 4 4 4 4 4 4 4 0 0 0 3 3 3 3 0 0 0 4 4 4 4 0 0 3 0 4 1 10 10 10 10 11 11 11 11 11 11 11 11 10 10 10 1 1 1 1                                                                                
1 1 1 1 4 4 4 4 4 4 4 4 4 4 0 1 1 3 1 1 0 4 4 4 4 4 0 0 0 0 0 0 0 0 0 0 0 4 4 4 4 4 4 4 4 4 4 4 0 3 0 0 4 4 4 4 4 4 4 4 0 0 0 3 3 0 0 0 0 0 4 4 4 4 4 0 0 3 0 4 1 10 10 10 10 11 11 11 11 11 11 11 11 10 10 10 1 1 1 1                                                                                
1 1 1 1 4 4 4 4 4 4 4 4 4 4 0 0 0 3 0 0 0 4 4 4 4 4 0 0 0 0 0 0 0 0 0 0 0 4 4 4 4 4 4 4 4 4 4 0 0 3 0 0 4 4 4 4 4 4 4 4 0 0 3 3 3 0 0 0 0 0 4 4 4 4 4 0 0 3 0 4 1 10 10 10 10 11 11 11 11 11 11 11 11 10 10 10 1 1 1 1                                                                                
1 1 1 1 4 4 4 4 4 4 4 4 4 4 0 0 0 3 0 0 0 4 4 4 4 4 4 4 4 0 3 3 3 3 0 0 4 4 4 4 4 4 4 4 4 4 4 0 0 3 0 0 4 4 4 4 4 4 4 4 0 0 3 3 0 0 0 0 0 4 4 4 4 4 4 0 0 3 0 4 1 1 1 1 1 1 1 1 11 11 1 1 1 1 1 1 1 1 1 1                                                                                
1 1 1 1 4 4 4 4 4 4 4 4 4 4 0 0 0 3 0 0 0 4 4 4 4 4 4 4 4 0 3 0 0 0 0 0 4 4 4 4 4 4 4 4 4 4 0 0 0 3 0 0 4 4 4 4 4 4 4 4 0 0 3 0 0 0 4 4 4 4 4 4 4 4 4 0 0 3 0 4 4 4 4 4 4 4 4 3 11 11 3 4 4 4 4 4 1 1 1 1                                                                                
1 1 1 1 4 4 4 4 4 4 4 4 4 4 0 0 0 3 0 0 4 4 4 4 4 4 4 4 4 0 3 0 0 0 0 0 4 4 4 4 4 4 4 4 4 4 0 0 0 3 0 0 4 4 4 4 0 0 0 0 3 3 3 0 0 0 4 4 4 4 4 4 4 4 4 4 4 3 3 3 0 3 3 3 0 3 3 3 3 0 3 4 4 4 4 4 1 1 1 1                                                                                
1 1 1 1 4 4 4 4 4 4 4 4 4 4 0 0 0 3 0 0 4 4 4 4 4 4 4 4 4 0 3 0 0 0 4 4 4 4 4 4 4 4 4 4 4 4 0 0 0 3 0 0 4 4 4 4 0 0 0 3 3 3 3 0 0 0 4 4 4 4 4 4 4 4 4 4 4 3 3 0 3 0 0 0 3 0 3 0 0 0 0 4 4 4 4 4 1 1 1 1                                                                                
1 1 1 1 4 4 4 4 4 4 4 4 4 4 0 0 0 3 0 0 4 4 4 4 4 4 4 4 4 0 3 0 0 0 4 4 4 4 4 4 4 4 4 4 0 0 0 0 3 3 3 0 0 0 0 0 0 3 3 3 3 3 0 0 4 4 4 4 4 4 4 4 4 4 4 4 4 4 4 0 0 0 0 0 0 0 0 0 0 0 3 4 4 4 4 4 1 1 1 1                                                                                
1 1 1 1 4 4 4 4 4 4 4 4 4 4 0 0 0 3 0 0 0 0 0 0 4 4 4 4 4 0 3 0 0 0 4 4 4 4 4 0 0 0 0 0 0 0 0 0 3 3 3 0 0 0 0 0 0 3 3 0 0 0 0 0 4 4 4 4 4 4 4 4 4 4 4 4 4 4 4 4 4 4 4 4 4 4 0 0 0 0 0 4 4 4 4 4 1 1 1 1                                                                                
1 1 1 1 4 4 4 4 4 4 4 4 4 4 0 0 0 3 0 0 0 0 0 0 0 0 0 0 0 0 3 0 0 0 0 0 0 0 0 0 0 0 0 0 0 0 0 3 3 3 3 3 0 0 0 0 3 3 3 0 0 0 0 0 4 4 4 4 4 4 4 4 4 4 4 4 4 4 4 4 4 4 4 4 4 4 4 4 4 4 4 4 4 4 4 4 1 1 1 1                                                                                
1 1 1 1 4 4 4 4 4 4 4 4 4 4 0 0 0 3 0 0 0 0 0 0 0 0 0 0 0 0 3 0 0 0 0 0 0 0 0 0 0 0 0 0 0 0 3 3 3 3 3 3 3 0 0 0 3 3 0 0 0 0 0 4 4 4 4 4 4 4 4 4 4 4 4 4 4 4 4 4 4 4 4 4 4 4 4 4 4 4 4 4 4 4 4 4 1 1 1 1                                                                                
1 1 1 1 4 4 4 4 4 4 4 4 4 4 0 0 0 3 3 3 3 3 3 3 3 3 3 3 3 3 3 3 3 3 3 3 3 3 3 3 3 3 3 3 3 3 3 3 3 3 3 3 3 3 3 3 3 0 0 0 0 0 0 4 4 4 4 4 4 4 4 4 4 4 4 4 4 4 4 4 4 4 4 4 4 4 4 4 4 4 4 4 4 4 4 4 1 1 1 1                                                                                
1 1 1 1 4 4 4 4 4 4 4 4 4 4 0 0 0 0 0 0 0 0 0 0 0 0 0 0 0 0 3 0 0 0 0 0 0 0 0 0 0 0 0 0 0 0 3 3 3 3 3 3 3 0 0 0 0 0 0 0 0 4 4 4 4 4 4 4 4 4 4 4 4 4 4 4 4 4 4 4 4 4 4 4 4 4 4 4 4 4 4 4 4 4 4 4 1 1 1 1                                                                                
1 1 1 1 4 4 4 4 4 4 4 4 4 4 0 0 0 0 0 0 0 0 0 0 0 0 0 0 0 0 3 0 0 0 0 0 0 0 0 0 0 0 0 0 0 0 0 3 3 3 3 3 0 0 0 0 0 0 0 0 0 4 4 4 4 4 4 4 4 4 4 4 4 4 4 4 4 4 4 4 4 4 4 4 4 4 4 4 4 4 4 4 4 4 4 4 1 1 1 1                                                                                
1 1 1 1 4 4 4 4 4 4 4 4 4 4 0 0 0 0 0 0 0 0 0 0 0 0 0 0 0 0 3 0 0 0 0 0 0 0 0 0 0 0 0 0 0 0 0 0 3 3 3 0 0 0 0 0 0 0 0 4 4 4 4 4 4 4 4 4 4 4 4 4 4 4 4 4 4 4 4 4 4 4 4 4 4 4 4 4 4 4 4 4 4 4 4 4 1 1 1 1                                                                                
1 1 1 1 4 4 4 4 4 4 4 4 4 4 4 4 4 4 4 4 4 4 4 4 4 4 4 4 4 4 3 4 4 4 4 4 4 4 4 4 4 4 4 4 0 0 0 0 0 3 0 0 0 0 0 0 0 0 0 4 4 4 4 4 4 4 4 4 4 4 4 4 4 4 4 4 4 4 4 4 4 4 4 4 4 4 4 4 4 4 4 4 4 4 4 4 1 1 1 1                                                                                
1 1 1 1 4 4 4 4 4 4 4 4 4 4 4 4 4 4 4 4 4 4 4 4 4 4 4 4 4 4 3 4 4 4 4 4 4 4 4 4 4 4 4 4 0 0 0 0 0 3 0 0 0 4 4 4 4 4 4 4 4 4 4 4 4 4 4 4 4 4 4 4 4 4 4 4 4 4 4 4 4 4 4 4 4 4 4 4 4 4 4 4 4 4 4 4 1 1 1 1                                                                                
1 1 1 1 4 4 4 4 4 4 4 4 4 4 4 4 4 4 4 4 4 4 4 4 4 4 4 4 4 4 3 4 4 4 4 4 4 4 4 4 4 4 4 4 0 0 0 0 0 3 0 0 0 4 4 4 4 4 4 4 4 4 4 4 4 4 4 4 4 4 4 4 4 4 4 4 4 4 4 4 4 4 4 4 4 4 4 4 4 4 4 4 4 4 4 4 1 1 1 1                                                                                
1 1 1 1 4 4 4 4 4 4 4 4 4 4 4 4 4 4 4 4 4 4 4 4 4 4 4 4 4 4 3 4 4 4 4 4 4 4 4 4 4 4 4 4 4 4 4 4 0 3 0 0 0 4 4 4 4 4 4 4 4 4 4 4 4 4 4 4 4 4 4 4 4 4 4 4 4 4 4 4 4 4 4 4 4 4 4 4 4 4 4 4 4 4 4 4 1 1 1 1                                                                                
1 1 1 1 4 4 4 4 4 4 4 4 4 4 4 4 4 4 4 4 4 4 4 4 4 4 4 4 4 4 3 4 4 4 4 4 4 4 4 4 4 4 4 4 4 4 4 4 0 3 0 0 0 4 4 4 4 4 4 4 4 4 4 4 4 4 4 4 4 4 4 4 4 4 4 4 4 4 4 4 4 4 4 4 4 4 4 4 4 4 4 4 4 4 4 4 1 1 1 1                                                                                
1 1 1 1 4 4 4 4 4 4 4 4 4 4 4 4 4 4 4 4 4 4 4 4 4 4 4 4 4 4 3 4 4 4 4 4 4 4 4 4 4 4 4 4 4 4 4 4 0 3 0 0 0 4 4 4 4 4 4 4 4 4 4 4 4 4 4 4 4 4 4 4 4 4 4 4 4 4 4 4 4 4 4 4 4 4 4 4 4 4 4 4 4 4 4 4 1 1 1 1                                                                                
1 1 1 1 4 4 4 4 4 1 1 1 1 1 1 1 4 4 4 4 4 4 4 4 4 4 4 4 4 4 3 4 4 4 4 4 4 4 4 4 4 4 4 4 4 4 4 4 0 3 0 4 4 4 4 4 4 4 4 4 4 4 4 4 4 4 4 4 4 4 4 4 4 4 4 4 4 4 4 4 4 4 4 4 4 4 4 4 4 4 4 4 4 4 4 4 1 1 1 1                                                                                
1 1 1 1 4 4 4 4 4 1 3 3 3 4 4 4 3 3 3 3 3 3 3 3 3 3 3 3 3 3 3 4 4 4 4 4 4 4 4 4 4 4 4 4 4 4 4 4 0 3 0 4 4 4 4 4 4 4 4 4 4 4 4 4 4 4 4 4 4 4 4 4 4 4 4 4 4 4 4 4 4 4 4 4 4 4 4 4 4 4 4 4 4 4 4 4 1 1 1 1                                                                                
1 1 1 1 4 4 4 4 4 1 3 3 3 3 4 1 4 4 4 4 4 4 4 4 4 4 4 4 4 4 4 4 4 4 4 4 4 4 4 4 4 4 4 4 4 4 4 4 0 3 0 4 4 4 4 4 4 4 4 4 4 4 4 4 4 4 4 4 4 4 4 4 4 4 4 4 4 4 4 4 4 4 4 4 4 4 4 4 4 4 4 4 4 4 4 4 1 1 1 1                                                                                
1 1 1 1 4 4 4 4 4 1 3 3 3 3 1 1 4 4 4 4 4 4 4 4 4 4 4 4 4 4 4 4 4 4 4 4 4 4 4 4 4 4 4 4 4 4 4 4 0 3 0 4 4 4 4 4 4 4 4 4 4 4 4 4 4 4 4 4 4 4 4 4 4 4 4 4 4 4 4 4 4 4 4 4 4 4 4 4 4 4 4 4 4 4 4 4 1 1 1 1                                                                                
1 1 1 1 4 4 4 4 4 1 3 3 3 3 1 4 4 4 4 4 4 4 4 4 4 4 4 4 4 4 4 4 4 4 4 4 4 4 4 4 4 4 4 4 4 4 4 4 0 3 0 4 4 4 4 4 4 4 4 4 4 4 4 4 4 4 4 4 4 4 4 4 4 4 4 4 4 4 4 4 4 4 4 4 4 4 4 4 4 4 4 4 4 4 4 4 1 1 1 1                                                                                
1 1 1 1 4 4 4 4 4 1 3 3 3 3 1 4 4 4 4 4 4 4 4 4 4 4 4 4 4 4 4 4 4 4 4 4 4 4 4 4 4 4 4 4 4 4 4 4 0 8 0 0 0 4 4 4 4 4 4 4 4 4 4 4 4 4 4 4 4 4 4 4 4 4 4 4 4 4 4 4 4 4 4 4 4 4 4 4 4 4 4 4 4 4 4 4 1 1 1 1                                                                                
1 1 1 1 4 4 4 4 4 1 1 1 1 1 1 4 4 4 4 4 4 4 4 4 4 4 4 4 4 4 4 4 4 4 4 4 4 4 4 4 4 4 4 4 4 4 4 4 0 8 0 0 0 4 4 4 4 4 4 4 4 4 4 4 4 4 4 4 4 4 4 4 4 4 4 4 4 4 4 4 4 4 4 4 4 4 4 4 4 4 4 4 4 4 4 4 1 1 1 1                                                                                
1 1 1 1 4 4 4 4 4 4 4 4 4 4 4 4 4 4 4 4 4 4 4 4 4 4 4 4 4 4 4 4 4 4 4 4 4 4 4 4 4 4 4 4 4 4 4 4 0 8 0 0 0 4 4 4 4 4 4 4 4 4 4 4 4 4 4 4 4 4 4 4 4 4 4 4 4 4 4 4 4 4 4 4 4 4 4 4 4 4 4 4 4 4 4 4 1 1 1 1                                                                                
1 1 1 1 4 4 4 4 4 4 4 4 4 4 4 4 4 4 4 4 4 4 4 4 4 4 4 4 4 4 4 4 4 4 4 4 4 4 4 4 4 4 4 4 4 4 4 4 0 8 0 0 0 4 4 4 4 4 4 4 4 4 4 4 4 4 4 4 4 4 4 4 4 4 4 4 4 4 4 4 4 4 4 4 4 4 4 4 4 4 4 4 4 4 4 4 1 1 1 1                                                                                
1 1 1 1 4 4 4 4 4 4 4 4 4 4 4 4 4 4 4 4 4 4 4 4 4 4 4 4 4 4 4 4 4 4 4 4 4 4 4 4 4 4 4 4 4 4 4 4 0 8 0 0 0 4 4 4 4 4 4 4 4 4 4 4 4 4 4 4 4 4 4 4 4 4 4 4 4 4 4 4 4 4 4 4 4 4 4 4 4 4 4 4 4 4 4 4 1 1 1 1                                                                                
1 1 1 1 4 4 4 4 4 4 4 4 4 4 4 4 4 4 4 4 4 4 4 4 4 4 4 4 4 4 4 4 4 4 4 4 4 4 4 4 4 4 4 4 4 4 4 4 0 8 0 0 4 4 4 4 4 4 4 4 4 4 4 4 4 4 4 4 4 4 4 4 4 4 4 4 4 4 4 4 4 4 4 4 4 4 4 4 4 4 4 4 4 4 4 4 1 1 1 1                                                                                
1 1 1 1 9 9 9 9 9 4 4 4 4 4 4 4 9 9 9 9 4 4 4 4 4 4 4 4 4 4 4 4 4 4 4 9 9 9 9 9 9 9 9 9 9 9 9 9 7 8 7 9 9 9 9 9 9 9 9 9 9 9 9 9 9 9 9 9 9 9 9 9 9 9 9 9 9 9 9 9 9 9 9 9 9 9 9 9 9 9 9 9 9 9 9 9 1 1 1 1                                                                                
1 1 1 1 9 9 9 9 9 4 4 4 9 9 9 9 9 9 9 9 9 9 9 9 4 4 4 4 9 9 9 9 9 9 9 9 9 9 9 9 9 9 9 9 9 9 9 9 7 8 7 7 9 9 9 9 9 9 9 9 9 9 9 9 9 9 9 9 9 9 9 9 9 9 9 9 9 9 9 9 9 9 9 9 9 9 7 7 7 7 7 9 9 9 9 9 1 1 1 1                                                                                
1 1 1 1 9 9 9 9 9 9 9 9 9 9 9 9 9 9 9 9 9 9 9 9 9 9 9 9 9 9 9 9 9 9 9 9 9 9 9 9 9 9 9 9 9 9 9 9 7 8 7 7 9 9 9 9 9 9 9 9 9 9 9 9 9 9 9 9 9 9 9 9 9 9 9 9 9 9 9 9 9 9 9 9 9 9 7 7 7 7 7 9 9 9 9 9 1 1 1 1                                                                                
1 1 1 1 9 9 9 9 9 9 9 9 9 9 9 9 9 9 9 9 9 9 9 9 9 9 9 9 9 9 9 9 9 9 9 9 9 9 9 9 9 9 9 9 9 9 9 9 7 8 7 7 9 9 9 9 9 9 9 9 9 9 9 9 9 9 9 9 9 9 9 9 9 9 9 9 9 9 9 9 9 9 9 9 9 9 7 7 7 9 9 9 9 9 9 9 1 1 1 1                                                                                
1 1 1 1 9 9 9 9 9 9 9 9 9 9 9 9 9 9 9 9 9 9 9 9 9 9 9 9 9 9 9 9 9 9 9 9 9 9 9 9 9 9 9 9 9 9 9 9 7 8 7 7 7 9 9 9 9 9 9 9 9 9 9 9 9 9 9 9 9 9 9 9 9 9 9 9 9 9 9 9 9 9 9 9 9 9 7 7 7 9 9 9 9 9 9 9 1 1 1 1                                                                                
1 1 1 1 9 9 9 9 9 9 9 9 9 9 9 9 9 9 9 9 9 9 9 9 9 9 9 9 9 9 9 9 9 9 9 9 9 9 9 9 9 9 9 9 9 9 9 9 7 8 7 7 7 9 9 9 9 9 9 9 9 9 9 9 9 9 7 9 9 9 9 9 9 9 9 9 9 9 9 9 9 9 7 7 7 7 7 7 7 9 9 9 9 9 9 9 1 1 1 1                                                                                
1 1 1 1 9 9 9 9 9 9 9 9 9 9 9 9 9 9 9 9 9 9 9 9 9 9 9 9 9 9 9 9 9 9 9 9 7 9 9 9 7 7 9 9 9 9 9 7 7 8 7 7 7 9 9 9 9 9 9 9 9 9 9 9 9 9 7 9 9 9 9 9 9 9 9 9 9 9 9 9 9 9 7 7 7 7 7 7 7 9 9 9 9 9 9 9 1 1 1 1                                                                                
1 1 1 1 9 9 9 9 9 9 9 9 9 9 7 9 9 9 9 9 7 7 9 9 9 9 9 9 9 9 9 9 9 9 9 9 7 9 9 9 7 7 9 9 9 7 7 7 7 8 7 7 7 9 9 9 9 9 9 9 9 9 7 7 7 7 7 9 9 9 9 9 9 9 9 9 9 9 9 9 9 9 7 7 7 7 7 7 7 9 9 9 9 9 9 9 1 1 1 1                                                                                
1 1 1 1 9 9 9 9 9 9 7 9 9 9 7 9 9 9 7 7 7 7 9 9 9 7 7 9 9 9 9 9 9 9 9 9 7 7 7 7 7 7 7 7 7 7 7 7 7 8 7 7 7 7 7 7 7 9 9 9 9 9 7 7 7 7 7 7 7 7 7 7 7 7 9 9 9 9 9 7 7 7 7 7 7 7 7 7 7 9 9 9 9 9 9 9 1 1 1 1                                                                                
1 1 1 1 9 9 9 9 9 9 7 9 9 9 7 9 9 9 7 7 7 7 7 7 7 7 7 9 9 9 9 9 9 7 7 7 7 7 7 7 7 7 7 7 7 7 7 7 7 8 7 7 7 7 7 7 7 7 7 7 7 7 7 7 7 7 7 7 7 7 7 7 7 7 9 9 9 9 9 7 7 7 7 7 7 7 7 7 7 9 9 9 9 9 9 9 1 1 1 1                                                                                
1 1 1 1 9 9 9 9 9 9 7 7 7 7 7 7 7 7 7 7 7 7 7 7 7 7 7 7 7 7 7 7 7 7 7 7 7 7 7 7 7 7 7 7 7 7 7 7 7 8 7 7 7 7 7 7 7 7 7 7 7 7 7 7 7 7 7 7 7 7 7 7 7 7 7 7 7 7 7 7 7 7 9 9 9 9 9 7 7 7 7 9 9 9 9 9 1 1 1 1                                                                                
1 1 1 1 9 9 9 9 9 9 7 7 7 8 8 8 8 8 8 8 8 8 8 8 8 8 8 8 8 8 8 8 8 8 8 8 8 8 8 8 8 8 8 8 8 8 8 8 8 8 8 8 8 8 8 8 8 8 8 8 8 8 8 8 8 8 8 8 8 8 8 8 8 8 8 8 7 7 7 7 7 7 9 9 9 9 9 7 7 7 7 9 9 9 9 9 1 1 1 1                                                                                
1 1 1 1 9 9 9 9 9 9 9 7 7 8 7 7 7 7 7 7 7 7 7 7 1 1 1 1 1 7 7 7 8 7 7 7 7 7 7 7 7 7 7 7 7 7 7 7 7 8 7 7 7 7 7 7 7 7 7 7 7 7 7 7 7 7 7 7 7 7 7 7 7 7 7 7 7 7 7 7 7 7 9 9 9 9 9 7 7 9 9 9 9 9 9 9 1 1 1 1                                                                                
1 1 1 1 9 9 9 9 9 9 9 7 7 8 7 7 7 7 7 7 7 7 7 7 1 8 8 8 1 7 7 7 8 7 7 7 7 7 7 7 7 7 7 7 7 7 7 7 7 7 7 7 7 7 7 7 7 7 7 7 7 7 7 7 7 7 7 7 7 7 7 7 7 7 7 7 7 7 7 7 7 7 9 9 9 9 9 7 7 9 9 9 9 9 9 9 1 1 1 1                                                                                
1 1 1 1 9 9 9 9 9 9 9 7 7 8 7 7 9 9 9 7 9 9 9 7 1 8 8 8 1 7 7 7 8 7 7 7 9 9 9 9 9 9 9 7 7 7 7 7 7 7 7 7 7 7 7 7 7 7 9 9 9 9 9 7 7 7 7 7 7 7 7 7 7 7 7 7 9 9 9 9 9 7 7 7 7 7 7 7 7 9 9 9 9 9 9 9 1 1 1 1                                                                                
1 1 1 1 9 9 9 9 9 9 9 7 7 8 7 7 9 9 9 7 9 9 9 7 1 8 8 8 1 7 7 7 8 7 7 7 9 9 9 9 9 9 9 9 9 9 9 9 7 7 7 7 7 7 7 7 7 7 9 9 9 9 9 9 9 9 9 9 9 9 9 9 7 7 7 7 9 9 9 9 9 7 7 7 7 7 7 7 7 9 9 9 9 9 9 9 1 1 1 1                                                                                
1 1 1 1 9 9 9 9 9 9 9 7 7 7 7 7 9 9 9 9 9 9 9 7 1 8 8 8 1 7 7 8 7 7 7 7 9 9 9 9 9 9 9 9 9 9 9 9 7 7 7 7 7 7 9 9 9 9 9 9 9 9 9 9 9 9 9 9 9 9 9 9 7 7 7 7 9 9 9 9 9 9 7 7 7 7 7 7 9 9 9 9 9 9 9 9 1 1 1 1                                                                                
1 1 1 1 9 9 9 9 9 9 9 7 7 7 7 7 9 9 9 9 9 9 9 7 1 8 8 8 1 7 7 8 7 7 9 9 9 9 9 9 9 9 9 9 9 9 9 9 7 9 9 9 9 9 9 9 9 9 9 9 9 9 9 9 9 9 9 9 9 9 9 9 7 7 7 7 9 9 9 9 9 9 7 7 7 7 7 7 9 9 9 9 9 9 9 9 1 1 1 1                                                                                
1 1 1 1 9 9 9 9 9 9 9 9 7 7 9 9 9 9 9 9 9 9 9 7 1 1 8 1 1 7 8 7 7 7 9 9 9 9 9 9 9 9 9 9 9 9 9 9 9 9 9 9 9 9 9 9 9 9 9 9 9 9 9 9 9 9 9 9 9 9 9 9 7 7 7 7 7 9 9 9 9 9 7 7 7 9 9 9 9 9 9 9 9 9 9 9 1 1 1 1                                                                                
1 1 1 1 9 9 9 9 9 9 9 9 9 9 9 9 9 9 9 9 9 9 9 7 7 7 8 8 8 8 8 7 7 9 9 9 9 9 9 9 9 9 9 9 9 9 9 9 9 9 9 9 9 9 9 9 9 9 9 9 9 9 9 9 9 9 9 9 9 7 7 7 7 7 7 9 9 9 9 9 9 9 7 7 7 9 9 9 9 9 9 9 9 9 9 9 1 1 1 1                                                                                
1 1 1 1 9 9 9 9 9 9 9 9 9 9 9 9 9 9 9 9 9 9 9 7 7 7 7 7 7 7 7 7 7 9 9 9 9 9 9 9 9 9 9 9 9 9 9 9 9 9 9 9 9 9 9 9 9 9 9 9 9 9 9 9 9 9 9 9 9 9 9 9 9 9 7 9 9 9 9 9 7 7 7 7 7 9 9 9 9 9 9 9 9 9 9 9 1 1 1 1                                                                                
1 1 1 1 9 9 9 9 9 9 9 9 9 9 9 9 9 9 9 9 9 9 9 9 9 9 9 7 7 7 7 7 9 9 9 9 9 9 9 9 9 9 9 9 9 9 9 9 9 9 9 9 9 9 9 9 9 9 9 9 9 9 9 9 9 9 9 9 9 9 9 9 9 9 7 9 9 9 9 9 7 7 7 7 7 9 9 9 9 9 9 9 9 9 9 9 1 1 1 1                                                                                
1 1 1 1 9 9 9 9 9 9 9 9 9 9 9 9 9 9 9 9 9 9 9 9 9 9 9 9 9 9 9 9 9 9 9 9 9 9 9 9 9 9 9 9 9 9 9 9 9 9 9 9 9 9 9 9 9 9 9 9 9 9 9 9 9 9 9 9 9 9 9 9 9 9 9 9 9 9 9 9 9 9 9 9 9 9 9 9 9 9 9 9 9 9 9 9 1 1 1 1                                                                                
1 1 1 1 9 9 9 9 9 9 9 9 9 9 9 9 9 9 9 9 9 9 9 9 9 9 9 9 9 9 9 9 9 9 9 9 9 9 9 9 9 9 9 9 9 9 9 9 9 9 9 9 9 9 9 9 9 9 9 9 9 9 9 9 9 9 9 9 9 9 9 9 9 9 9 9 9 9 9 9 9 9 9 9 9 9 9 9 9 9 9 9 9 9 9 9 1 1 1 1                                                                                
1 1 1 1 9 9 9 9 9 9 9 9 9 9 9 9 9 9 9 9 9 9 9 9 9 9 9 9 9 9 9 9 9 9 9 9 9 9 9 9 9 9 9 9 9 9 9 9 9 9 9 9 9 9 9 9 9 9 9 9 9 9 9 9 9 9 9 9 9 9 9 9 9 9 9 9 9 9 9 9 9 9 9 9 9 9 9 9 9 9 9 9 9 9 9 9 1 1 1 1                                                                                
1 1 1 1 9 9 9 9 9 9 9 9 9 9 9 9 9 9 9 9 9 9 9 9 9 9 9 9 9 9 9 9 9 9 9 9 9 9 9 9 9 9 9 9 9 9 9 9 9 9 9 9 9 9 9 9 9 9 9 9 9 9 9 9 9 9 9 9 9 9 9 9 9 9 9 9 9 9 9 9 9 9 9 9 9 9 9 9 9 9 9 9 9 9 9 9 1 1 1 1                                                                                
1 1 1 1 9 9 9 9 9 9 9 9 9 9 9 9 9 9 9 9 9 9 9 9 9 9 9 9 9 9 9 9 9 9 9 9 9 9 9 9 9 9 9 9 9 9 9 9 9 9 9 9 9 9 9 9 9 9 9 9 9 9 9 9 9 9 9 9 9 9 9 9 9 9 9 9 9 9 9 9 9 9 9 9 9 9 9 9 9 9 9 9 9 9 9 9 1 1 1 1                                                                                
1 1 1 1 1 1 1 1 1 1 1 1 1 1 1 1 1 1 1 1 1 1 1 1 1 1 1 1 1 1 1 1 1 1 1 1 1 1 1 1 1 1 1 1 1 1 1 1 1 1 1 1 1 1 1 1 1 1 1 1 1 1 1 1 1 1 1 1 1 1 1 1 1 1 1 1 1 1 1 1 1 1 1 1 1 1 1 1 1 1 1 1 1 1 1 1 1 1 1 1                                                                                
1 1 1 1 1 1 1 1 1 1 1 1 1 1 1 1 1 1 1 1 1 1 1 1 1 1 1 1 1 1 1 1 1 1 1 1 1 1 1 1 1 1 1 1 1 1 1 1 1 1 1 1 1 1 1 1 1 1 1 1 1 1 1 1 1 1 1 1 1 1 1 1 1 1 1 1 1 1 1 1 1 1 1 1 1 1 1 1 1 1 1 1 1 1 1 1 1 1 1 1                                                                                
1 1 1 1 1 1 1 1 1 1 1 1 1 1 1 1 1 1 1 1 1 1 1 1 1 1 1 1 1 1 1 1 1 1 1 1 1 1 1 1 1 1 1 1 1 1 1 1 1 1 1 1 1 1 1 1 1 1 1 1 1 1 1 1 1 1 1 1 1 1 1 1 1 1 1 1 1 1 1 1 1 1 1 1 1 1 1 1 1 1 1 1 1 1 1 1 1 1 1 1                                                                                
1 1 1 1 1 1 1 1 1 1 1 1 1 1 1 1 1 1 1 1 1 1 1 1 1 1 1 1 1 1 1 1 1 1 1 1 1 1 1 1 1 1 1 1 1 1 1 1 1 1 1 1 1 1 1 1 1 1 1 1 1 1 1 1 1 1 1 1 1 1 1 1 1 1 1 1 1 1 1 1 1 1 1 1 1 1 1 1 1 1 1 1 1 1 1 1 1 1 1 1                                                                                
